0000000000000222
0000000000000000
0000000000000012
0000000000000020
0000000000000020
0000000000000020
0000000000000020
0000000000000020
0000000000000020
0000000000000020
0000000000000020
0000000000000020
0000000000000020
0000000000000020
0000000000000020
0000000000011120
0000000000000000
0000000000000000
---
15 1 # Start
15 3 # End
---
