2221111111111222
0000000000000000
2024444444444222
0000000000000020
1000000000000020
0000000000000020
0010000000000020
0000000000000020
1000000000000020
0000000000000020
0010000000000020
0000000000000020
1000000000000020
0000000000000020
0010000000000020
0000000000011120
1000000000000000
0000000000000000
---
15 1 # Start
15 3 # End
---
