2233333333333322
0000000000000022
0000000000000002
0000000005000002
2000050000000002
2400000000000000
2200000000000000
2200000000000010
2200000000000000
2000000000000000
2000050000000004
2000000005000002
0000000000000002
0000000000000002
0100000000000002
0000000000000012
0000000000000002
0000000000000000
---
0 1 # Start
14 16 # End
---
