0000000000000111
0000000000000000
0000000110000000
0000000000000000
0111000000500000
0000000000000000
0000000000002000
0000050110002402
0000000000002242
0000000000002222
1000000000000222
0000000010000222
0000000000022222
0111050000032222
0000220000000552
2000222400420552
2000222222222222
0000000000000000
---
---
14 1 # Start
2 14 # End
3 # Next
