1112222222222222
0002222332332222
0002220000000222
1112200005000022
0002200010000022
0002200121100022
1112205220000022
0002200220000022
0002220020001022
0000220022400022
0000000002200030
0000000002205000
2211000002210000
2220000002200000
2225001042200111
2222000022200000
2222200022205000
0000000000000000
---
---
1 1 # Start
14 15 # End
4 # Next
