2222222333011111
2233333000000000
2300000000500400
2000000004004240
2600022222442220
2200033332222224
2200050003332222
2224000000003333
2222240000500000
2222222240000000
2222222222222225
2222222222222330
0222222222333000
0002233333000000
1113300000000000
0000000000050000
0000000500000000
0000000000000000
---
---
1 15 # Start
12 1 # End
5 # Next
