0000001110000000
0000000000000000
0000000000000000
0000000000000000
0000000000000000
0000000000000000
0001111111111000
0003333333333000
0000000000000000
0000000000000000
0000000000000000
0001111111111000
0003333333333000
0000000000000000
0000000000000000
1110000000000000
0000000000000000
0000000000000000
---
1 0 14 1.25
1 0 13 1.3 
1 0 15 1.67
-1 0 10 0.99
-1 0 9 1.25
-1 0 8 1.09
1 0 5 1.09
1 0 4 0.94
1 0 3 1.09
1 0 2 1.15
---
1 16 # Start
7 1 # End
7 # Next
