0000000000000000
0000000000000000
0000000000000000
0000000000000000
1111111111111111
2002000000000020
2002000000000000
2000000002000000
2000000002000000
2222222222222222
0000000000000000
0000000000000000
0000000000000000
0000000000000000
0000000000000000
0000000000000000
0000000000000000
0000000000000000
---
1 0 8 10   
---
1 5 # Start
15 10 # End
8 # Next
