2211111222222222
2000000002222222
2000000000020022
2000000000000002
0000011100000000
0000000000000000
0000000000000000
0000000000110000
0000000000000000
0001110000000000
1000000000000000
0000000000000000
0000000000000000
0010000000000060
0000000000000111
0000000000000000
0000500000000000
0000000000000000
---
---
3 1 # Start
14 15 # End
2 # Next
